4  0  2  8  2 16  4 16  4  8
4  0  8 13  8 16  9 16  9 13
4  0 12 11 12 14 15 14 15 11
4  0  7  6  7 10  9 10  9  6
4  0  1  3  1  6  4  6  4  3
4  0  5  1  5  2  9  2  9  1
4  0 11  0 11  8 13  8 13  0
