4    0  600 1800  650 1900  750 1850  850 1650    0    0
4    0  100  600  180  700  300  600  220  450    0    0
4    0  200  850  250 1100  350 1150  350  750    0    0
5    0  200 1250  100 1450  250 1800  400 1500  350 1200
4    0  450   50  350  200  500  350  900   50    0    0
5    0  600  350  550  500  550  600  700  600  850  500
4    0  450  850  500 1100  600 1200  550  750    0    0
4    0  900  450  850  650 1100  700 1200  500    0    0
5    0  850  950  800 1300  900 1350 1100 1200 1100  900
5    0 1250  600 1300  700 1400  650 1500  500 1350  350
4    0 1150 1200 1300 1250 1400 1000 1200  950    0    0
5    0 1150 1550 1050 1800 1100 1850 1300 1750 1250 1500
4    0 1500  900 1600  950 1750  750 1700  700    0    0
4    0 1400 1300 1350 1650 1450 1700 1650 1400    0    0
4    0 1650 1050 1700 1300 1950 1200 1900  950    0    0
