26 0  10 140  10 150  20 150  20 170  30 170  30 180  40 180  40 190  50 190  50 200  60 200  60 190  70 190  70 180  80 180  80 150  70 150  70 140  60 140  60 130  40 130  40 120  30 120  30 130  20 130  20 140
20 0  90 140  90 150 100 150 100 180 120 180 120 190 130 190 130 180 150 180 150 170 160 170 160 160 150 160 150 140 130 140 130 130 110 130 110 120 100 120 100 140   0   0   0   0   0   0   0   0   0   0   0   0
20 0 160 100 160 120 170 120 170 130 180 130 180 140 190 140 190 150 210 150 210 160 220 160 220 140 230 140 230 130 220 130 220 100 210 100 210  90 180  90 180 100   0   0   0   0   0   0   0   0   0   0   0   0
10 0 190 200 190 210 200 210 200 230 220 230 220 220 230 220 230 190 200 190 200 200   0   0   0   0   0   0   0   0   0   0   0   0   0   0   0   0   0   0   0   0   0   0   0   0   0   0   0   0   0   0   0   0
26 0  70  50  70  70  80  70  80  80 130  80 130  70 150  70 150  60 160  60 160  50 220  50 220  40 200  40 200  30 220  30 220  20 180  20 180  10 170  10 170  20 160  20 160  30 150  30 150  40  80  40  80  50
