26 0  10 140  10 150  20 150  20 170  30 170  30 180  40 180  40 190  50 190  50 200  60 200  60 190  70 190  70 180  80 180  80 150  70 150  70 140  60 140  60 130  40 130  40 120  30 120  30 130  20 130  20 140
20 0  90 140  90 150 100 150 100 180 120 180 120 190 130 190 130 180 150 180 150 170 160 170 160 160 150 160 150 140 130 140 130 130 110 130 110 120 100 120 100 140   0   0   0   0   0   0   0   0   0   0   0   0
20 0 280 100 280 120 290 120 290 130 300 130 300 140 310 140 310 150 330 150 330 160 340 160 340 140 350 140 350 130 340 130 340 100 330 100 330  90 300  90 300 100   0   0   0   0   0   0   0   0   0   0   0   0
10 0 310 200 310 210 320 210 320 230 340 230 340 220 350 220 350 190 320 190 320 200   0   0   0   0   0   0   0   0   0   0   0   0   0   0   0   0   0   0   0   0   0   0   0   0   0   0   0   0   0   0   0   0
26 0  70  50  70  70  80  70  80  80 130  80 130  70 150  70 150  60 160  60 160  50 340  50 340  40 320  40 320  30 340  30 340  20 180  20 180  10 170  10 170  20 160  20 160  30 150  30 150  40  80  40  80  50
